XXXXXXXXXXXXX
X      H    X
X X XXXXXXXXX
X           X
X           X
X           X
X           X
X           X
X   F       X
X           X
X         F X
XXXXXXXXXXXXX